NO textures/BlueWall.xpm
SO textures/BrownWall.xpm
WE textures/GrayBrick.xpm
EA textures/RedWall.xpm
DO textures/door.xpm
A1 textures/anim1.xpm
A2 textures/anim2.xpm

F 50,50,50
C 150,240,255

        1111111111111111111111111
        1000000000110000000000001
        1011000001110000000000001
        10010000000D0000000000001
111111111011000001110000000000001
10000000001100000111011111D111111
1111D111111111D11100000010001
11110111111111011101010010001
11000000110101011100000010001
10000000000000001100000010001
10000000000000001101010010001
11000001110101011111011110S01
11110111 1110101 101111010001
11111111 1111111 11111111AAA1
